                                   111  11            1  11 1
                                  100011001         1101100101
                                  1011 101         10101100001     1
                                  101111011     1  10101101101111110111
                                1110000100011111011100000000000000000001
                               1000000000000000000000001110110000000001
      1                         11001110000000000111101  100011111010011
   11101        11            11100011000010101101 1101  100101  10000001
  100001      11001          10000001 111010001101101011 100101  1010101
   10101     100101          1000011011 100000000110001011001001  100101
   10101    1100001           101011010100000000000000001000000111110001
  111101   10000001           10001101000100001111000000000011010000011
 1000001111100100001           1000001000000001   1111010101 10111100111
  100000000000001001            110000000000001  1   100011  101011000001
   1110000000110000011            1100111100001 101111001  11100000001101
     101011101100000001           11001000001011100000001110000101111  1
   1 101010000000000011          10101100000000000000000000000011
  101101011100000000000111    11110000001011101111000001101100111
  10110001 1011100000000001  100000000000001101  100011  1 1000001
  1011011  1101100000100001  10010111111111110111111001    101111
 1001101111000000000010001   10110111111110000000000001    101
  101100000000001110000001   10000000000011111100010101     1
  101100000001100000000011111100111111101      10110101
 110000000111 1011100000000000001      1        1 101011
1000110000111110001000101100110011                10000011
10101100000000101110000000001101101                10001101
10101100000000101 10101111001001101                 1001101
10000001000110001 10001  10010000011              110000101
 111111 100000001 10101 1000111110001            1000010101
         11111101 1000111000000000101             111000001
              101100001010000000000001               111101
              101 10101010000000111001111111        11111001
              1111100010000000001110000000001      100000011 1
             10000000010110101100000111100001       11101000101
             1001011000011010110011011000000111       101001101
             10000110011 10101100000000000000001      10100000111
             1000000001  1000000000001101110111        11000100001
             1010000001   11000000000011  101           100010101
             1011111101     10010000010011 1             1111011
             101    101     100000000000001                 101
             10111 1001     10111111000011                  101       1
            1000001 11       1      1111            1       101    11101
             1011001                               101      101   100001
              1 1001                               101     11011  1101011
                 11                     1111111111110111111000101100000001
                                      110000000000000000000000101100100001
                                     1000000000000000000000000001101101101
                                    10000000010000100000000000001101100001
                                     1101111010100000000111100001100100001
                                      101  10101000000001   111000001000N111
                                      101  10100000000001111111000001000000011
                                      101  101010000000100000010000000000000001
                                      101  10000000000000000000011001110000111
                                       1   101111110000100000000000000000000001
                                        1  10101   111010001110100000000000001
                                       1011100001    100000000000001000000011
                                     11000000101     1000000110000000001101
                                    100011111101     10000001 1011001101 1
                                     111     101     1000011  100001  1
                                              1       1111     1111