NO 255, 255, 0

WE 245, 222, 179

SO 196, 180, 84

EA 255, 170, 51

F 220, 254, 25
C 225, 30, 125



    111111111111  11111111
    1000000000011110000111    111
    10000111111101000000011111101
    1000000000000000000000000000111
1111111111111000000011111111111111111111111
            100000000001
       11111000000000011
  111  111111111100000001     1
 1111111110000100000001111   11
 10000000000000S0000001      1
 111111111111111110000011111
 10000000000000000011001111
11111111111111111111111111111111
 1000000001 1000000000001
 1111111111 11111111111111