NO 255, 255, 0
SO 196, 180, 84
WE 245, 222, 179
EA 255, 170, 51

F 220, 100, 0
C 225, 30, 0






    111111111111  11111111
    100000000001 110000111111111
    1000011111111100000000000001
    1000000000000000000001000001
11111111111100000000011111111111
10000000000000000000000001
10000S000000100000000000010
10000000111111111100000001
10000000000001000000001111
10000000000000000000001
1111111111111111100000111111
10000000000000000011001111
10111111111111111110000001
10000000001 10000000000001
11111111111 11111111111111