NO 255, 255, 0

SO 196, 180, 84

WE 245, 222, 179

EA 255, 170, 51

F 220, 100, 0
C 225, 30, 0



    111111111111  11111111
    1000000000011110000111    111
    10000111111101000000011111101
    1000000000000000000000000000111
11111111111110000000111111111111111
            100000000001
       11111000000000011
  111  111111111100000001     1
 111111111000010000N0001111   11
 1000000000000000000001      1
 111111111111111110000011111
 10000000000000000011001111
11111111111111111111111111111111
 1000000001 1000000000001
 1111111111 11111111111111