NO 255, 255, 0
SO 196, 180, 84
WE 245, 222, 179
EA 255, 170, 51

F 220, 100, 0
C 225, 30, 0






    1111111111110011111111
    1000000000010110000111111111
    1000011111111110000000000001
    1000000000000000000001000001
11111111111100000000011111111111
10000000000000000000000001
10000S00000001000000000001
10000000111111111100000001
10000000000001000000001111111111111111111
10000000000000000000001
11111111111111111000001111
10000000000000000011111111
10111111111111111110000001
10000000001 10000000000001
11111111111 11111111111111