NO ./cub3d_pics/bluestone.xpm

WE ./cub3d_pics/eagle.xpm

SO ./cub3d_pics/greystone.xpm

EA ./cub3d_pics/redbrick.xpm

F 220, 255, 25

C 225, 30, 125



    11111111111  11111111
    100000000011110000111    111
    100011111110100000011111101
    1000000000100100000000111101        1
11111111111111010N011111111111111111111101
            10010000011                 1
   1   1111101001100011
 1101111110000011110001     1
11101111111011011010001111  11
11000111100001000000000001      1
 1101111111111100111111011111
 11011110000000000000011001111
1111111111111111000111111111111111
 1000000001 1000000000001
 1111111111 11111111111111