NO 255, 255, 0

WE 245, 222, 179

SO 196, 180, 84

EA 255, 170, 51

F 220, 254, 25
C 225, 30, 125



    111111111111  11111111
    100000000011110000111    111
    100011111110100000011111101
    1000000000100100000000111101        1
111111111111110100011111111111111111111101
            10010000011                 1
   1   11111010011E0011
 1101111110000011110001     1
11101111111011011010001111  11
11000111100001000000000001      1
 110111111111111111111111011111
 11011110000000000000011001111
1111111111111111000111111111111111
 1000000001 1000000000001
 1111111111 11111111111111
