
C            225, 191,       0

NO ./cub3d_pics/MiConv.com__output-onlinepngtools (2).xpm




WE ./cub3d_pics/MiConv.com__output-onlinepngtools (1).xpm

SO          ./cub3d_pics/eagle_test.xpm

EA ./cub3d_pics/greystone.xpm

F 230, 230, 250

    1111111111  1111111
    100000000011110000111
    1000111111101000000111111111111
    10000000001001000000001111111111
1111111111100000111111111111
111111111110000011111111111111111111
1111111111111011100011111111
  11111111110010101011111111
11111111111110111011111111111
11111111111100000111111111111
111111111111100001111111111111
11111111111110111011111111111
11111111111100000111111111111
111111111111100001111111111111
11111111111110111011111111111
11111111111100000111111111111
111111111111100001111111111111
11111111111110111011111111111
11111111111100000111111111111
111111111111100001111111111111
11111111111110111011111111111
11111111111100000111111111111
111111111111100001111111111111
11111111111110111011111111111
11111111111100000111111111111
11111111111100000111111111111
111111111111100001111111111111
11111111111110111011111111111
11111111111100000111111111111
111111111111100001111111111111
1111111111111000001111111111111111111111
11111111111110N0011111
1111111111111111111
