NO 255, 255, 0
SO 196, 180, 84
WE 245, 222, 179
EA 255, 170, 51

F 220, 100, 0
C 225, 30, 0






    111111111111  11111111
    1000000000011110000111111111
    1000011111110100000000000001
    1000000000000000000001000001
111111101111100000001111111111111111111111
            100000000001
       11111000000000011
  111  111111111100000001
 11110111100001000000001111
 10000000000000000000001
 1111111111111111100000111111
 10000000000000000011001111
 11111111111111111110000001
 1000000001 10000000000001
 1111111111 11111111111111