
C             225, 191,       0

NO ./cub3d_pics/MiConv.com__output-onlinepngtools (2).xpm



WE ./cub3d_pics/MiConv.com__output-onlinepngtools (1).xpm

SO ./cub3d_pics/eagle_test.xpm

EA ./cub3d_pics/greystone.xpm

F 210, 25, 125




1111111
1010001
1010N01
1010001
1010001
1010001
1010001
1111111
