NO ./cub3d_pics/bluestone.xpm

WE ./cub3d_pics/eagle.xpm

SO ./cub3d_pics/greystone.xpm

EA ./cub3d_pics/redbrick.xpm

F 220, 254, 25
C 225, 30, 125



    111111111111  11111111
    100000000011110000111    111
    100011111110100000011111101
    1000000000100100000000111101
11111111111110000111111111111111111111
11111111111110000111111111111111111111
11111111111110000111111111111111111111
11111111111110000111111111111111111111
11111111111110000111111111111111111111
11111111111110000111111111111111111111
11111111111110000111111111111111111111
11111111111110000111111111111111111111
111111111111100E0111111111111111111111
11111111111111111111111111111111111111