NO 255, 255, 0

WE 245, 222, 179

SO 196, 180, 84

EA 255, 170, 51

F 220, 254, 25
C 225, 30, 125



    111111111111  11111111
    100000000011110000111    111
    100011111110100000011111101
    1000000000100100000000111101
11111111111110000111111111111111111111
11111111111110000111111111111111111111
11111111111110000111111111111111111111
11111111111110000111111111111111111111
11111111111110000111111111111111111111
11111111111110000111111111111111111111
11111111111110N00111111111111111111111
11111111111110000111111111111111111111
11111111111110000111111111111111111111
11111111111111111111111111111111111111