NO ./cub3d_pics/bluestone.xpm

WE ./cub3d_pics/eagle.xpm

SO ./cub3d_pics/greystone.xpm

EA ./cub3d_pics/redbrick.xpm

F 220, 255, 25

C 225, 30, 125



    11111111111  11111111
    100000000011110000111    111
    1000011111110100000011111101
    100000000010010000000000111
111111111111110100011111111111111111111111
            10010000011
   1   11111010001100011
  1011 11100000011110001     1
111011111110110111101111   11
1100011000001011000000001      1
 11N10111111111110000011111
 111110000000000000000011001111
11111111111111111111111111111111
 1000000001 1000000000001
 1111111111 11111111111111