
NO ./cub3d_pics/MiConv.com__output-onlinepngtools (2).xpm

WE ./cub3d_pics/MiConv.com__output-onlinepngtools (1).xpm

SO ./cub3d_pics/greystone.xpm

EA ./cub3d_pics/redbrick.xpm

F 220, 254, 251
C 225, 30, 125



    111111111111  11111111
    100000000011110000111    111
    100011111110100000011111101
    1000000000100100000000111101
11111111111110000011111111111111111111
11111111111110000011111111111111111111
1111111111111011100011111111111111111111
11111111111110101011111111111111111111
11111111111110111011111111111111111111
111111111111100W0011111111111111111111
11111111111110000011111111111111111111
11111111111110000011111111111111111111
11111111111110000011111111111111111111
11111111111111111111111111111111111111