    111111111111  11111111
    100000000011110000111    111
    1000011111110100000011111101
    100000000010010000000000111
11111111111111010N011111111111111111111111
            1001000011
   1   1111101001100011
  1011 1110000011110001     1
111011111110110110101111   11
1100011000001011000000001      1
 11010111111111001000011111
 11011000000000000000011001111
11111111111111111111111111111111
 1000000001 1000000000001
 1111111111 11111111111111