    111111111111  11111111
    100000000011110000111    111
    1000011111110100000011111101
    100000000000000000000000111
111111111111100000011111111111111111111111
            100000000001
   1   11111000000000011
  101  111011111100000001     1
 11011111100100000011111   11
 10010100000000000000001      1
 10N101111111111110000011111
 111110000000000000000011001111
11111111111111111111111111111111
 1000000001 1000000000001
 1111111111 11111111111111